R 1920 1024

NO  textures/wallgrass.xpm
SO  textures/swamp.xpm
WE  textures/greystone.xpm
EA  textures/woodwall.xpm
S   textures/shrek.xpm

F  0,153,0
C  102,255,255

1111111111111111111111111
1000000000000011100000001
1000000000000000000000001
1111111100000000000000001
1000000000000000000000001
1000000000000200000001111
1111111111000000000000001
1000000000000000000000001
1000E00000000000000000001
1000001110000000000000001
1111111111111111111111111
